11111111111111111111111
10000000000000000000000
30000000006666000000000
30000000090000000000000
30500000000000000000000
30000022000000330000000
30000022000000300000004
30000000000000300000000
14050000003333300000000
10000000000000000000002
22222222222222222222222