11111111111111111111111
10000000000000000000000
30000000006666000000000
30000000090000000000000
30500000000000000000 0 0 0
300000880000003300 0 -1 0 00
30000088000000300000 0 0 4
30000000000000300000000
14050000003333300000000
10000000000000000000002
22222222222222222222222