11111111111111111111111
10000000000000000000001
10005000003333000000001
10000000000000000000001
10000000000000000000001
10000022000000330000001
10000022000000300000001
10000000000000300000001
14444000003333300000001
10000000000000000000001
11111111111111111111111