11111111111111111111111
10000000000000000000001
10000000006666000000001
10000000000000000000001
10500000000000000000001
10000022000000330000001
10000022000000300000001
10000000000000300000001
14050000003333300000001
10000000000000000000001
11111111111111111111111