1111111111111111111111111111111111111111111111
1000000000000000000000000000000000000000000001
1000000000000000000000000200000000030000000001
1000000000044400004400000000000000030000000001
1000111100000000004033033323333330030000111101
1000000000000004004000000000000300030000100101
1000010000000004004000000020000300030000101101
1000010000000004004000000000000333033011101001
1000010000000004004000000200000000000000001001
1000010000030000000000000000000000000011110001
1000010000030000000000000200000050006000000001
1000000000030003000000000000000000006000333031
1111111100030003000000002220000000006000300001
1000000000030003000000002000000000066000300001
1000000000033033000000002020000000060000300001
1000000000000000000000002020000000660000334001
1000666600003000000000002220000000003000000001
1000000666666000000000000000000000003000000001
1000000000000000000000000200000000000000000001
1111111111111111111111111111111111111111111111