1000010000030000000000000000000000000011110001
100001000003000000000000020000002000600
1000000000030003000000000000000000006000333031
111111110003000     0000222
10
100000050000       0000000000aweifiuasdfj sadjkfijaewkje
10000000056660000000000002000000000011000000001
1000000000002000000900000000000000000000000001
1000000000002000000000000200000000030000000001
1000000000044400004400000000000000030000000001
1000111100000000004033033323333330030000111101
1000000000000004004000000000000300030000100101
10000100000000040 0020000300030000101101
10000100000000040040000000000
1000010000000004004000000200000000000000001001
1000010000080000000000000000000000000011110001
100001000008000000000000020000002000600
1000000000030003000000000000000000006000333031