1111111111111111111111111111111111111111111111
1000000000000000000000000000000000000000000001
1000000000000000000000000200000000030000000001
1000000000044400004400000000000000030000000001
1000111100000000004033033323333330030000000001
1000000000000004004000000000000300030000000001
1000000000000004004000000020000300030000000001
1000005000000004004000000000000333033000000001
1000000000000004004000000200000000000000000001
1000000000030000000000000000000000000000000001
1000000000030000000000000200000000006000000001
1000000000030003000000000000000000006000000001
1000000000030003000000002220000000006000000001
1000000000030003000000002000000000066000000001
1000000000033033000000002020000000060000000001
1000000000000000000000002020000000660000000001
1000666600000000000000002220000000003000000001
1000000666666000000000000000000000003000000001
1000000000000000000000000200000000000000000001
1111111111111111111111111111111111111111111111