42	31	1	43	31	100	31	11	5	13	44	1
2	0	0	0	0	0	0	0	0	0	0	11
42	0	0	0	0	0	0	0	0	0	0	12
2	0	0	0	0	0	0	0	0	0	0	11
42	0	0	0	0	0	0	0	0	0	0	85
2	0	0	0	-1	0	0	0	0	0	0	45
42	0	0	0	0	0	0	0	0	0	0	88
2	0	0	0	0	0	0	0	0	0	0	41
42	0	0	0	0	0	0	0	0	0	0	55
2	0	-2	56	-2	0	0	0	0	0	0	22
42	0	0	0	0	0	0	0	0	0	0	3
2	4	4	31	121	10	23	10	30	42	11	2