42	31	1	43	31	100	31	11	5	13	44	1
2	7	0	0	31	0	10	0	10	30	42	11
42	31	1	43	31	102	31	11	5	13	88	12
2	0	0	0	0	0	0	10	30	42	11	11
42	31	0	-1	0	100	31	11	5	13	32	85
2	0	0	0	0	0	0	0	0	42	11	45
42	31	0	43	0	100	0	11	0	13	96	88
2	0	0	0	0	0	0	10	0	0	0	41
42	0	1	43	0	100	0	0	0	13	7	55
2	0	0	31	0	0	0	10	30	0	11	22
42	31	1	43	31	100	31	11	5	13	0	3
2	4	4	31	121	10	23	10	30	42	11	2