11	93	20	80	24	79	73	8	70	77	7	77	14	91	44	45	60	72	25	88	92	17	84	26	71	27	77	70	8	65
16	0	68	0	0	0	0	0	68	85	0	0	0	0	0	0	0	0	0	0	0	0	0	20	0	0	10	0	0	2
35	63	78	0	0	-1	0	0	0	0	63	0	46	0	0	20	76	0	0	0	65	0	21	40	0	0	98	0	0	27
18	75	0	0	0	0	0	5	0	0	13	0	0	0	48	0	33	0	72	26	0	47	55	0	0	0	0	0	0	72
71	0	57	0	0	0	0	0	0	8	4	0	86	0	0	96	0	50	69	0	0	0	0	45	0	0	0	0	0	39
69	0	0	0	0	40	42	0	94	6	0	0	0	10	80	79	21	0	0	77	54	53	21	0	0	0	76	10	95	3
2	99	44	0	100	79	11	63	7	98	0	0	0	0	0	62	0	0	99	44	0	0	0	0	0	0	86	0	0	91
97	56	15	0	0	0	0	0	0	9	75	0	26	67	0	0	0	0	0	0	0	0	25	0	0	0	0	0	75	39
81	67	30	0	40	0	0	0	33	0	44	0	99	0	73	0	3	0	0	73	0	0	50	0	0	0	0	0	33	23
33	0	0	0	17	0	0	0	0	0	0	0	44	0	0	0	0	0	45	13	0	4	0	70	15	0	0	0	0	45
12	0	0	0	61	0	0	0	0	0	14	13	0	0	0	0	0	0	11	17	0	0	0	57	0	0	20	82	80	86
22	0	0	92	0	22	0	0	0	0	0	6	90	0	0	83	0	0	0	0	0	89	0	0	0	0	70	49	0	61
6	0	0	0	0	0	0	0	0	66	0	0	0	0	17	0	0	0	0	3	0	0	0	53	0	0	71	7	0	26
63	0	50	71	27	0	0	0	69	0	0	77	0	0	0	0	52	0	0	0	0	0	0	0	76	0	0	0	78	14
58	0	0	95	0	99	44	15	0	83	0	18	88	8	0	0	99	0	0	0	39	30	0	3	88	0	10	85	0	72
93	0	0	0	0	0	87	0	0	0	0	0	18	0	0	0	0	72	51	0	80	54	0	0	0	0	0	66	0	13
3	0	31	0	0	24	77	74	0	63	65	0	17	24	53	0	0	24	78	0	25	0	0	0	68	0	0	0	42	91
44	52	0	0	0	70	0	54	0	0	0	0	0	0	0	71	0	0	38	0	87	75	16	0	67	0	0	0	0	16
75	59	0	45	0	0	0	0	49	49	0	0	0	0	94	51	0	0	84	16	5	0	0	0	0	0	0	31	62	49
36	0	28	32	0	0	0	0	12	0	0	0	0	0	0	73	48	56	97	94	0	0	0	0	15	41	0	13	0	20
38	0	0	11	89	46	0	47	82	0	0	0	0	0	32	0	0	0	0	60	0	0	0	0	0	0	37	0	67	64
87	0	59	39	42	90	2	4	0	59	79	0	0	0	0	38	31	0	43	0	0	18	0	0	74	0	61	0	65	33
36	0	0	0	63	0	0	0	0	0	34	33	0	46	0	100	0	0	0	0	0	61	0	0	0	0	96	0	71	47
88	0	99	0	60	0	0	0	0	0	25	0	55	55	0	0	0	0	0	27	0	0	0	0	65	0	36	0	0	64
42	0	0	9	73	0	0	0	4	53	0	0	57	0	0	69	2	0	0	0	0	0	0	0	0	0	0	48	0	89
34	0	19	21	0	0	0	0	0	0	80	0	59	0	0	0	97	0	0	0	0	13	0	0	0	0	0	0	0	40
45	0	0	0	0	89	100	0	66	0	0	0	0	100	0	16	0	92	71	71	0	32	26	23	0	94	0	0	0	49
35	0	89	0	0	0	0	0	0	45	0	0	0	0	0	0	0	0	0	0	0	50	26	0	0	0	11	0	0	63
49	0	71	0	0	0	28	0	0	0	0	0	0	41	0	0	0	38	76	0	0	0	0	0	51	0	91	71	0	26
60	26	49	44	40	8	73	85	10	25	22	84	86	60	85	38	49	4	21	76	5	71	33	61	26	2	89	11	41	7
