31	87	22	92	27	78	47	87	99	89	51	54	59	88	3	55	55	21	48	30	53	59	72	20	28	90	71	91	7	82	24	61	58	100	40	40	37	1	100	32	29	66	71	93	97	43	31	60	61	34	53	4	94	27	47	45	3	60	40	44	80	71	89	8	22	32	49	43	86	93	92	11	84	8	94	7	34	47	89	60	85	31	37	13	43	65	100	75	98	90	71	19	86	72	39	86	63	47	41	37
35	68	51	0	22	0	0	0	0	0	0	34	0	0	0	18	0	0	0	0	0	0	0	0	0	0	0	28	0	0	0	0	0	0	0	0	0	0	45	24	0	0	0	0	87	0	36	0	0	0	0	0	0	0	0	98	0	23	0	0	0	0	0	0	0	0	0	0	0	0	0	0	0	0	13	0	0	0	0	0	0	0	0	0	42	0	0	55	0	0	0	0	0	0	0	0	0	0	0	33
69	0	4	16	93	0	0	0	0	0	0	0	0	0	0	0	0	15	0	0	0	0	0	0	0	0	0	0	0	0	30	0	61	0	0	0	0	46	0	0	0	0	0	0	0	0	0	0	0	0	0	84	0	0	0	0	0	0	0	0	0	0	0	0	0	76	0	62	26	0	0	0	0	0	0	0	0	79	0	0	40	0	0	0	54	63	88	0	0	0	0	0	0	0	0	0	0	0	0	56
29	0	0	0	0	0	0	0	0	0	0	0	35	0	0	0	0	0	0	93	0	0	0	0	0	0	0	0	0	0	0	0	4	0	0	37	45	0	0	0	0	78	58	0	0	0	0	0	0	0	0	0	0	0	0	25	67	0	0	0	0	47	0	94	0	0	0	0	17	0	46	0	0	52	0	0	0	0	0	0	0	0	0	0	0	0	0	0	0	0	0	0	0	0	0	0	0	0	0	35
11	0	16	0	0	0	64	0	0	0	85	7	0	0	0	0	67	0	80	0	0	11	0	53	0	0	0	0	48	0	0	0	0	0	0	0	0	0	0	0	0	0	0	0	0	0	0	41	0	0	0	0	0	0	9	18	0	0	0	0	53	0	0	0	0	11	0	0	77	0	0	0	0	91	0	0	0	0	51	0	0	0	0	0	0	30	38	0	0	0	0	79	0	0	0	0	0	0	0	100
32	0	0	0	68	0	0	0	0	39	0	0	0	0	0	0	0	0	0	0	0	0	0	0	0	0	0	0	36	0	0	0	0	0	56	0	15	0	47	0	0	0	0	0	22	27	0	0	55	93	0	0	0	0	0	0	0	0	55	0	0	0	0	0	0	0	0	0	0	0	0	0	0	0	0	0	0	0	0	0	0	0	65	37	0	0	0	0	0	51	0	0	81	0	0	0	0	0	45	19
27	62	31	0	78	0	0	0	0	0	0	0	92	0	0	0	0	24	0	0	0	0	57	6	0	0	0	0	0	0	0	16	0	0	0	0	0	0	0	0	41	0	69	0	0	0	0	0	57	2	0	0	0	0	0	0	0	0	0	0	0	0	0	0	0	0	5	0	0	0	0	0	0	4	0	0	0	97	0	0	0	0	0	0	0	0	0	0	0	0	0	0	0	84	0	0	0	0	0	34
96	0	0	0	0	79	0	0	0	0	0	0	0	0	0	0	0	0	84	5	0	0	49	0	2	0	0	0	0	0	0	0	0	0	49	0	0	0	0	0	0	0	0	0	0	0	0	0	0	22	0	80	0	0	0	0	0	13	0	0	0	0	0	0	0	0	0	0	0	0	0	0	0	79	0	0	0	0	0	71	0	0	0	0	0	0	0	0	92	24	0	0	0	0	0	0	0	96	97	21
87	0	0	0	0	0	0	0	0	0	0	0	0	0	0	0	0	0	0	0	0	0	55	0	0	0	31	0	0	65	88	0	0	0	0	0	0	0	60	10	0	0	0	0	83	0	0	0	0	0	0	0	0	0	0	0	0	0	0	0	0	0	0	75	0	0	0	0	0	0	0	0	0	0	0	0	0	0	0	0	0	0	0	0	0	0	0	0	0	0	0	0	0	0	0	0	0	0	0	77
62	0	0	0	0	0	0	0	0	0	0	0	0	0	0	0	0	0	0	0	0	0	0	0	0	37	0	0	30	0	0	0	0	0	0	0	0	0	0	53	0	0	0	0	0	0	0	0	0	0	40	0	0	22	0	0	35	33	0	0	0	0	0	63	0	0	89	0	0	0	0	0	0	0	0	90	0	0	0	0	17	90	49	0	0	0	0	0	0	0	65	0	13	0	0	0	0	0	0	58
47	0	0	0	0	68	0	0	0	0	0	0	0	0	0	0	0	0	0	0	0	0	0	0	0	0	0	0	0	0	0	0	0	0	0	89	0	0	0	0	0	0	0	0	65	0	19	0	0	0	0	0	0	0	0	0	0	0	0	0	0	0	0	0	0	0	0	0	0	0	0	0	0	0	0	0	0	0	0	0	0	0	0	0	0	8	0	0	0	0	0	0	20	0	0	0	0	0	0	37
79	8	0	0	0	0	0	0	0	0	0	0	0	0	0	0	99	0	0	0	0	0	0	0	89	0	51	0	0	0	0	0	53	0	0	0	0	0	0	0	0	0	0	0	0	0	0	0	0	0	0	0	0	0	0	0	0	0	18	0	0	0	0	0	0	0	0	0	0	0	0	0	0	0	0	0	0	0	0	0	0	0	0	0	0	0	0	0	0	0	0	0	0	0	0	0	33	71	0	73
76	0	0	0	0	0	0	0	0	0	0	0	0	0	0	0	11	0	0	0	0	0	0	0	0	0	0	0	69	0	0	0	0	0	0	36	0	0	0	0	0	0	0	0	0	0	0	0	0	0	0	0	0	0	0	0	0	0	32	0	0	0	0	29	19	0	0	0	0	0	0	0	0	0	0	0	0	0	0	0	0	0	0	0	0	0	0	33	0	0	0	0	0	0	0	0	0	31	71	66
98	0	0	95	0	0	0	0	0	13	26	0	0	0	0	0	0	0	0	0	0	0	0	0	0	0	0	0	0	0	0	0	0	0	0	0	71	18	0	0	0	0	0	0	0	0	0	54	0	0	0	0	0	0	0	0	0	0	0	0	0	0	93	0	0	0	0	0	0	0	72	0	0	0	0	0	0	0	0	52	0	0	0	0	27	0	0	0	0	0	0	53	0	0	4	0	0	0	0	10
71	0	0	0	0	0	0	9	0	23	0	0	0	0	54	0	89	0	0	0	0	0	0	0	0	76	0	0	0	0	0	0	0	0	0	0	0	0	0	0	0	52	0	0	0	0	0	0	0	0	0	0	59	0	0	0	0	0	0	0	47	0	0	0	0	0	0	75	0	0	0	0	0	84	0	0	0	0	69	0	100	0	0	0	0	0	0	0	0	0	0	0	0	0	0	0	0	0	0	69
94	0	0	0	81	0	45	75	0	0	40	0	0	0	0	0	0	0	80	0	4	0	0	0	60	0	0	0	0	0	0	0	0	0	0	0	0	0	0	0	0	0	0	0	83	0	0	91	0	0	0	0	0	81	0	0	51	60	0	0	0	0	0	0	0	0	0	0	0	61	0	0	0	0	98	0	0	0	0	0	0	0	0	0	0	0	0	0	0	0	0	0	0	0	0	0	0	0	0	67
27	0	0	0	61	0	0	0	0	0	0	0	74	0	0	0	0	0	0	82	0	0	0	0	0	0	45	0	0	0	0	0	0	75	0	0	0	0	0	0	93	83	0	0	0	0	0	0	0	0	43	47	11	0	0	0	0	0	0	0	0	0	0	0	47	0	0	0	0	0	0	0	0	0	26	0	0	0	0	0	0	0	0	0	0	0	78	0	0	0	0	0	99	0	0	0	0	0	38	100
35	0	99	0	0	0	0	0	96	0	0	0	0	0	25	0	0	0	0	0	0	0	0	0	0	0	0	0	0	0	0	0	0	78	0	22	0	23	0	0	0	0	0	0	88	0	0	0	47	0	0	0	0	0	0	0	0	0	0	0	0	0	3	0	0	0	0	0	0	64	0	0	92	0	0	0	57	0	0	0	0	0	0	0	0	47	0	0	0	0	0	0	4	0	0	0	0	52	0	54
44	0	0	0	0	0	0	0	0	0	0	0	5	0	0	0	0	0	0	0	0	0	0	0	37	0	0	0	0	0	0	0	0	0	0	0	0	81	0	0	0	0	0	0	0	0	0	0	0	0	0	0	22	0	0	0	0	0	0	0	0	0	0	0	34	0	0	0	0	0	0	0	0	85	0	0	0	0	0	0	0	0	0	0	0	0	0	0	0	0	0	0	0	0	0	0	0	0	0	68
37	0	0	0	0	7	0	0	0	0	0	0	0	20	0	0	0	0	0	65	0	0	0	0	0	0	0	0	0	0	0	40	0	0	0	42	0	0	0	28	0	0	80	0	0	0	0	0	0	0	0	0	0	45	0	0	0	0	40	61	0	56	0	0	0	0	0	47	0	0	0	48	0	0	0	0	0	0	27	0	0	0	17	0	30	0	15	97	0	0	0	0	42	0	0	0	19	0	76	35
78	0	0	0	0	0	0	0	0	0	0	0	0	0	0	0	49	0	33	0	0	0	0	0	0	0	31	0	0	63	0	0	0	0	0	0	0	0	0	2	0	0	0	0	0	0	0	0	0	0	0	0	16	0	0	0	0	95	0	0	0	0	0	0	0	0	0	0	0	0	0	0	0	0	90	0	0	0	75	0	0	0	0	67	0	0	31	75	2	0	0	0	0	0	0	0	0	0	0	86
73	0	0	0	37	0	0	0	0	0	0	50	0	0	0	0	0	79	0	0	0	0	0	0	0	0	0	0	0	0	0	0	0	0	0	0	0	0	0	0	0	0	0	0	55	0	58	0	0	0	0	0	0	0	0	0	0	13	0	0	0	0	0	0	0	0	0	0	0	0	0	72	0	0	0	0	0	8	0	0	0	0	0	0	0	0	0	48	0	0	0	0	0	0	25	56	0	0	0	33
11	0	0	0	0	0	0	0	0	0	91	0	0	0	47	0	0	0	0	0	0	0	0	0	54	59	0	69	0	0	0	84	72	0	0	0	0	0	0	94	0	0	0	0	0	0	0	0	0	0	0	0	0	0	0	50	0	0	0	0	0	0	29	0	0	0	0	0	0	0	0	70	0	0	0	0	8	0	0	31	0	0	0	90	0	0	0	0	0	0	0	0	0	0	0	0	0	82	0	4
29	0	0	0	0	70	0	42	0	0	0	0	0	0	0	0	0	0	0	0	0	0	0	0	0	0	0	0	0	0	0	0	0	0	0	0	0	0	100	0	0	0	0	0	0	0	0	0	0	12	0	86	0	0	0	0	0	0	0	0	0	0	0	0	0	0	0	0	93	0	0	0	0	0	0	0	0	0	28	0	0	0	0	0	0	0	0	0	0	0	0	0	0	0	0	0	0	0	0	55
1	0	0	0	0	0	0	0	0	55	65	0	0	0	0	0	0	0	0	0	0	0	0	0	0	0	0	0	0	0	0	0	0	0	0	0	0	0	0	5	0	0	0	0	0	0	0	0	0	0	72	0	0	0	65	0	0	0	0	0	0	0	0	0	0	0	0	0	0	0	4	0	0	0	0	0	0	0	0	0	0	0	0	0	0	63	63	0	0	0	21	0	0	0	0	0	0	0	0	69
23	0	0	0	0	0	0	36	0	0	34	0	0	97	0	0	0	58	0	0	0	0	0	0	0	48	0	0	0	0	90	0	53	0	0	75	0	49	0	0	0	0	0	0	0	0	0	0	47	0	0	0	0	8	0	0	64	0	87	0	0	0	0	0	0	0	0	0	65	0	88	0	0	88	0	0	0	0	0	0	0	0	0	0	0	23	0	0	0	0	0	0	0	0	0	0	0	0	73	9
88	0	0	0	0	72	14	67	0	0	0	0	0	0	0	0	0	0	0	0	0	0	0	0	0	87	0	32	0	0	66	0	25	0	0	0	0	0	0	0	0	0	0	0	0	0	0	0	0	0	0	0	0	0	0	0	17	0	0	70	0	0	0	0	0	2	0	0	0	0	0	0	0	32	0	0	0	34	0	0	0	0	0	0	0	0	0	0	0	0	0	0	0	0	0	67	0	0	0	47
97	24	0	47	0	0	0	0	0	0	0	0	0	0	0	0	0	0	0	0	0	0	0	82	78	0	0	0	0	0	0	0	0	0	0	0	0	0	0	0	0	73	0	0	67	0	0	0	0	0	0	98	0	0	98	0	92	0	0	0	0	0	0	27	28	0	0	0	0	0	0	0	40	0	0	0	0	0	0	0	0	0	0	0	13	0	0	0	0	0	0	0	63	0	0	0	0	0	0	8
95	0	0	0	0	0	0	0	0	0	0	0	0	0	0	0	0	0	0	0	0	0	0	0	0	0	0	0	0	0	0	0	0	0	0	83	0	0	0	55	0	0	0	0	0	0	0	0	0	0	0	92	0	4	0	0	0	0	83	0	0	8	0	0	80	27	0	0	49	0	0	0	0	0	46	0	0	0	0	0	0	0	0	53	0	30	0	0	0	0	0	0	0	0	0	0	0	0	0	6
96	0	86	0	0	0	0	0	0	0	0	0	0	0	0	0	81	0	0	0	0	0	0	0	0	0	0	0	0	0	91	0	0	0	0	0	0	0	0	0	17	0	0	0	0	0	0	0	0	0	0	0	0	0	0	0	0	0	0	0	0	0	0	0	0	0	0	0	0	0	0	0	0	0	0	0	0	0	0	0	0	13	64	0	0	49	0	18	8	0	0	40	0	0	44	0	0	0	0	85
53	0	0	0	38	0	14	0	0	0	0	0	0	76	0	0	0	0	0	58	0	0	0	0	0	0	0	87	0	0	0	0	0	0	0	0	0	0	0	0	0	0	0	41	0	0	0	0	0	0	0	0	0	0	0	0	0	0	0	0	0	0	0	0	0	0	9	0	0	0	0	0	0	0	0	0	0	0	0	16	29	0	0	0	0	0	0	75	0	0	0	0	0	0	0	0	0	0	0	29
2	0	0	0	0	0	0	0	97	0	0	21	0	1	0	0	0	0	0	0	0	0	0	0	0	0	0	68	0	0	0	0	0	0	0	0	0	0	0	0	0	0	0	0	54	0	97	0	0	0	0	0	0	0	0	0	0	0	0	100	0	0	0	0	0	89	0	0	0	0	0	0	36	0	0	75	0	96	0	63	73	0	0	0	0	0	0	0	0	0	0	0	0	0	0	0	59	0	0	74
60	0	0	22	0	0	0	0	0	23	0	0	0	0	0	0	0	0	27	0	0	63	0	0	0	0	0	0	0	0	0	51	0	0	0	0	0	0	0	0	0	0	0	0	83	0	0	83	91	0	3	0	0	0	0	52	0	0	0	0	61	0	0	0	0	0	0	0	0	0	0	0	0	0	0	0	98	0	66	0	55	0	65	0	0	0	0	0	0	0	35	0	0	0	89	0	0	0	0	75
73	0	0	0	0	0	0	0	0	0	0	0	0	0	0	0	0	0	0	0	0	94	0	0	0	0	0	88	40	0	0	0	0	0	0	0	0	0	0	0	0	0	0	0	0	0	0	36	0	0	0	0	0	24	0	0	18	0	0	0	0	0	0	64	0	0	0	0	0	0	0	0	0	0	0	0	40	0	0	0	0	0	0	0	0	0	0	0	0	0	0	0	5	0	30	0	0	0	0	88
68	0	73	73	0	0	0	72	0	0	39	99	0	0	0	90	0	0	0	0	0	46	0	0	0	0	0	0	0	0	0	0	0	0	32	40	0	0	0	0	0	0	0	0	0	0	0	0	0	86	0	0	0	90	0	5	0	0	0	9	0	0	56	0	0	26	0	0	0	40	48	0	0	0	0	12	0	0	0	0	34	0	0	0	0	0	0	0	0	0	41	0	0	0	0	0	0	25	0	1
63	0	0	0	64	0	91	0	0	0	71	0	0	0	0	0	0	0	69	0	0	82	0	0	0	0	0	0	0	0	0	0	0	0	0	0	0	0	74	11	0	0	0	0	0	0	0	0	16	0	0	0	0	0	0	0	0	0	0	0	0	0	0	0	0	0	0	0	0	0	0	0	0	0	0	0	0	0	0	0	0	0	38	25	0	0	97	0	0	82	17	0	0	0	0	0	0	0	68	54
51	0	0	0	0	50	0	0	0	0	0	0	0	0	0	0	0	0	0	0	0	0	42	0	0	0	0	0	62	0	92	0	0	0	0	0	0	0	0	0	0	0	0	33	0	0	0	0	0	0	11	0	0	67	0	0	93	0	0	0	0	0	58	0	14	0	0	0	0	0	0	0	0	92	0	0	0	0	0	0	0	0	0	0	0	0	0	0	0	0	0	0	0	0	0	0	0	0	0	48
92	0	0	0	0	0	0	0	74	0	62	59	0	0	0	0	80	0	0	0	0	0	0	0	0	0	0	0	0	0	0	0	0	89	0	0	0	0	0	0	0	0	0	0	0	0	0	0	0	0	0	0	0	0	0	0	29	0	0	0	0	0	0	0	0	0	0	0	0	0	0	0	0	0	88	0	0	0	0	0	0	82	0	0	0	0	0	35	0	0	95	0	0	0	0	0	0	0	0	60
69	0	37	0	0	0	0	0	14	85	80	0	89	0	3	0	0	0	0	45	0	0	0	0	0	0	0	0	0	0	0	0	0	0	0	0	0	0	0	0	0	0	0	0	91	0	0	0	0	28	0	0	6	0	0	11	0	50	0	0	0	60	0	0	0	0	0	0	65	36	0	0	40	0	0	0	0	0	0	0	0	0	0	0	0	0	0	14	0	0	0	0	0	0	85	0	0	0	0	49
82	0	93	0	15	0	0	0	39	0	0	0	0	0	0	0	0	0	0	0	0	0	0	0	0	38	0	0	0	46	54	0	0	0	0	0	0	0	87	0	0	0	0	0	0	0	0	0	0	0	0	0	0	0	0	0	55	0	59	0	0	0	0	0	0	0	0	0	9	0	0	37	0	0	0	0	0	71	0	0	95	0	0	0	0	0	0	0	0	18	6	0	0	13	0	0	61	15	0	34
5	0	0	61	55	0	27	0	0	0	0	0	0	0	0	0	0	0	0	89	0	0	0	0	0	0	0	0	0	0	0	0	0	0	70	0	0	0	0	0	76	60	88	0	0	0	0	33	58	0	0	0	0	0	0	91	0	0	0	0	0	0	0	0	0	0	0	0	94	0	1	0	0	0	0	0	0	0	99	3	0	0	0	0	0	0	0	84	82	1	0	33	0	0	0	0	0	0	0	93
24	0	0	0	0	0	0	0	0	0	0	0	0	0	0	0	0	0	0	0	0	0	0	0	0	0	0	56	0	0	0	0	0	54	0	6	0	0	26	0	0	22	43	0	0	0	0	0	0	0	56	0	0	0	58	0	0	60	0	0	0	0	0	0	0	0	0	0	0	0	0	0	61	0	0	0	0	0	0	0	0	0	0	0	0	0	0	0	0	0	0	0	0	0	0	0	0	0	0	74
62	0	0	0	85	0	5	0	0	0	0	0	55	0	0	0	40	0	0	0	0	0	0	0	0	0	100	0	0	0	0	0	31	9	0	0	0	0	0	0	0	0	0	0	0	0	0	0	0	0	0	14	35	0	0	0	90	48	0	19	0	0	0	0	0	68	0	0	0	0	50	0	0	0	0	0	69	0	0	97	0	5	26	0	0	0	0	0	0	0	0	15	33	0	0	0	0	54	0	78
61	0	0	0	0	0	0	0	3	0	0	0	82	0	0	6	0	0	0	0	0	0	0	0	0	0	0	88	0	20	0	0	0	0	0	0	0	0	0	0	21	0	0	0	0	0	0	0	0	0	0	0	0	9	0	0	0	0	0	0	0	0	0	13	46	0	0	0	57	57	0	0	25	0	0	78	0	91	0	0	0	0	79	0	0	0	0	0	95	0	77	0	0	0	0	0	0	0	0	7
1	0	0	0	0	0	0	0	17	0	0	0	0	0	0	0	0	0	0	0	40	0	0	0	0	0	0	0	0	0	0	0	0	0	0	0	0	0	0	0	0	0	0	0	0	0	0	0	0	0	0	0	27	0	0	0	0	52	0	27	69	0	0	0	80	0	0	0	89	0	0	0	0	0	0	61	0	0	0	0	0	0	0	0	0	0	0	0	0	0	0	97	0	0	0	0	0	0	0	46
31	0	0	0	0	0	0	0	0	0	0	0	0	0	0	0	28	0	0	6	0	0	0	22	0	0	0	0	0	0	0	0	0	0	0	0	0	58	0	0	0	0	40	0	0	0	0	0	54	0	0	28	0	0	0	0	78	0	0	0	0	0	0	78	0	0	0	0	0	0	0	0	0	0	96	0	64	42	0	0	0	0	0	88	0	0	0	0	0	0	0	0	0	0	66	0	61	0	0	71
90	0	0	0	0	0	70	0	0	0	95	0	0	0	0	0	0	0	0	66	0	0	0	0	20	0	0	0	0	0	67	0	0	0	0	0	0	0	12	0	0	53	0	0	0	0	0	0	0	0	0	0	0	0	0	0	0	0	0	0	0	0	0	0	0	0	34	0	0	0	83	0	0	0	0	0	57	0	0	0	0	0	0	0	0	0	0	0	0	0	0	0	0	0	0	0	0	0	0	49
2	0	0	0	0	0	0	0	0	0	35	0	0	73	0	0	0	0	0	0	0	0	81	64	82	98	0	0	0	0	0	0	0	0	0	0	76	0	0	0	0	0	34	0	0	0	68	0	0	15	0	0	0	0	0	0	0	0	0	50	0	0	0	0	0	0	0	0	0	0	0	0	0	0	0	0	0	0	0	0	0	6	26	0	0	50	0	0	0	0	28	83	38	0	0	0	0	0	0	80
19	50	0	0	0	0	0	48	0	81	96	0	0	0	0	0	0	0	65	0	0	0	0	0	0	0	27	0	0	0	0	63	0	0	0	0	0	0	0	0	0	0	0	0	0	0	0	0	0	0	0	20	0	0	0	0	0	0	0	0	0	0	0	0	0	0	0	0	0	0	0	0	16	95	0	0	0	0	47	0	0	69	0	0	0	72	0	0	0	0	0	0	80	0	0	43	0	0	42	72
31	0	0	0	0	74	0	0	0	0	0	0	90	0	0	66	0	66	0	0	0	0	0	0	0	0	0	72	0	90	0	0	0	0	0	0	0	0	0	0	38	0	0	0	0	0	0	21	0	0	0	0	81	0	0	0	0	29	0	0	0	0	0	0	0	0	0	0	0	0	0	0	0	88	0	0	0	0	0	0	0	0	0	0	44	0	0	41	0	0	67	0	0	0	0	40	0	0	0	35
69	0	94	0	11	0	23	0	25	0	0	0	0	0	88	0	76	0	0	0	0	0	0	0	0	94	0	0	35	0	0	0	0	0	0	15	0	16	0	0	0	0	0	0	99	0	80	0	90	31	68	0	0	84	35	14	0	0	0	0	0	0	0	0	16	0	0	0	5	68	0	0	0	0	25	0	0	0	0	0	8	0	85	0	0	0	0	0	29	0	0	50	67	0	0	0	0	0	0	56
100	0	0	0	0	0	0	0	0	1	92	0	58	13	0	0	0	0	0	78	0	0	0	0	0	0	68	0	0	0	0	0	0	0	0	59	0	0	24	0	0	0	0	76	0	0	0	0	0	0	97	0	0	0	0	0	0	14	0	0	0	0	0	0	40	0	0	0	0	0	0	0	0	0	0	0	0	0	0	0	0	0	0	0	0	36	0	0	0	0	0	0	0	0	0	2	0	0	0	21
83	40	0	0	0	0	0	0	0	0	0	0	56	0	0	0	0	91	51	0	0	0	0	0	0	100	0	0	0	41	0	27	0	0	74	0	0	0	0	0	0	0	0	0	0	0	0	82	0	0	97	74	0	0	0	0	4	0	0	0	0	0	0	0	0	0	0	36	0	3	0	0	26	0	0	0	0	0	0	55	0	0	0	0	72	0	0	0	38	0	0	0	0	0	0	0	0	38	0	16
54	0	0	0	0	0	0	0	17	0	0	0	46	0	0	53	0	0	0	0	0	0	0	0	57	0	0	0	0	0	0	0	0	0	0	0	0	0	26	0	0	0	0	0	0	0	0	60	34	0	0	0	0	0	0	0	19	0	0	0	33	0	0	0	0	0	0	0	0	25	11	0	0	0	0	0	0	0	0	0	0	0	0	0	0	0	0	0	0	0	0	0	0	0	0	0	67	0	0	35
91	62	45	0	0	0	62	0	0	0	0	30	0	0	0	0	0	0	85	0	0	0	0	38	87	100	0	0	0	0	93	0	0	0	0	0	0	0	0	0	0	82	0	0	0	25	0	67	0	0	0	0	0	0	0	0	0	0	0	0	0	0	0	0	19	0	0	0	0	0	0	0	0	0	0	37	0	0	0	21	0	0	0	0	20	33	0	0	0	0	0	93	0	0	0	0	0	0	0	49
63	0	65	0	0	0	85	70	0	0	71	0	0	0	0	0	0	0	0	10	0	0	89	0	0	0	0	0	0	47	74	0	0	0	0	0	0	0	0	41	0	0	0	0	0	0	0	0	65	0	0	0	0	31	0	0	0	0	41	0	0	0	14	0	0	0	0	0	41	27	0	0	0	0	0	0	0	0	0	0	78	73	0	0	0	0	79	0	0	61	0	0	17	0	0	0	0	0	0	2
44	62	0	0	0	0	0	0	0	0	39	0	0	100	0	0	0	0	0	0	0	0	0	0	67	0	0	0	0	0	0	0	56	29	0	0	0	0	0	0	9	10	0	0	0	0	0	0	0	0	0	0	81	17	0	0	9	0	0	0	0	0	0	0	0	0	0	6	0	0	0	0	0	0	0	0	0	0	0	0	0	0	0	0	0	38	0	0	0	0	3	0	0	0	0	0	0	0	14	59
96	0	0	0	0	0	0	62	0	0	0	0	0	0	0	0	0	0	0	0	0	0	0	0	72	0	0	0	0	0	0	0	0	0	0	0	0	0	0	0	0	0	0	0	0	28	24	0	0	0	0	0	73	0	0	25	0	0	0	0	0	0	0	0	0	0	0	0	0	0	0	0	0	0	0	0	0	0	0	0	0	0	0	0	0	0	0	0	0	0	0	0	0	0	72	0	0	0	0	77
6	36	0	0	0	0	0	0	94	0	0	0	0	0	85	40	15	0	0	0	0	83	0	0	0	0	0	2	0	0	0	0	0	0	0	0	0	0	0	0	0	0	0	22	0	0	0	0	0	0	26	0	0	49	39	0	0	0	0	0	48	0	53	0	0	0	0	0	0	0	0	0	0	0	0	0	0	0	0	0	0	16	0	0	0	0	0	86	0	0	0	8	0	0	0	0	0	0	0	50
19	0	0	0	73	0	0	78	0	0	0	0	0	30	0	0	0	0	0	0	0	0	0	0	0	0	0	0	0	0	0	0	0	0	0	0	0	0	0	85	0	0	0	0	0	0	0	71	0	0	0	0	20	0	0	0	0	0	58	0	0	0	0	0	0	0	0	63	0	0	0	82	0	0	78	0	0	67	0	0	0	0	0	0	0	0	0	0	0	0	0	0	0	0	0	0	58	81	0	88
29	0	0	0	0	0	99	0	0	0	0	76	0	0	0	16	0	0	0	0	0	0	0	0	0	0	0	0	0	25	0	0	0	0	0	0	0	0	0	68	0	0	0	0	0	0	0	99	0	0	0	0	0	0	0	79	0	0	0	0	0	0	0	0	0	0	0	0	0	0	0	0	0	0	0	0	0	0	0	0	0	0	0	0	0	0	0	0	0	0	0	92	24	0	0	0	0	0	0	25
94	0	0	0	0	0	0	0	0	0	0	0	58	0	0	0	0	10	0	26	0	0	0	0	0	0	0	0	0	0	0	0	0	8	0	0	0	0	0	0	0	0	0	0	0	0	0	0	0	0	0	87	0	0	0	0	0	0	0	0	0	0	34	0	0	0	0	26	0	0	0	0	0	0	0	0	0	92	0	0	0	0	21	0	0	0	0	0	0	0	0	0	0	0	0	0	0	0	0	42
47	0	0	15	0	0	0	0	0	0	0	0	0	0	34	0	21	0	0	0	0	0	0	0	0	0	0	0	0	0	0	72	0	0	0	0	52	57	0	0	0	100	0	2	0	0	0	0	0	0	30	76	0	0	41	0	0	0	0	0	0	0	0	0	0	0	0	0	0	0	0	0	0	0	0	0	0	0	0	0	0	0	0	0	0	0	0	0	0	0	0	0	0	0	0	0	0	0	99	48
51	0	0	0	0	0	0	0	62	5	2	0	0	0	0	0	0	52	0	0	0	0	0	0	0	0	0	0	94	0	0	0	1	0	0	0	50	0	0	0	68	0	96	0	0	0	54	0	0	0	0	0	75	0	0	0	0	0	0	0	0	0	0	30	0	0	0	0	82	64	0	0	0	0	0	0	0	42	0	0	0	57	0	0	9	0	0	0	0	0	0	0	0	0	0	0	59	0	0	97
67	0	0	92	0	0	0	0	0	0	80	0	0	0	77	0	0	0	0	0	0	0	0	37	66	47	0	18	0	87	0	0	0	94	0	0	0	0	0	0	0	0	0	41	0	0	0	0	0	0	0	0	0	0	0	0	17	0	0	0	0	0	17	0	0	0	0	0	0	98	0	35	0	0	0	0	57	0	0	0	9	0	0	0	15	0	0	24	0	0	0	0	0	0	0	0	0	93	0	68
65	0	0	0	0	0	0	0	0	0	0	0	0	0	0	0	0	0	0	0	0	0	0	0	0	0	0	0	0	0	0	0	31	0	0	0	0	0	0	0	0	0	96	0	0	0	0	0	0	0	0	0	0	0	0	73	0	90	0	0	0	0	0	0	0	0	0	0	0	0	0	0	0	0	74	66	0	0	0	0	39	0	0	0	58	0	0	0	0	0	0	0	0	0	0	0	0	0	0	38
97	0	0	0	92	0	0	0	0	0	0	0	0	31	0	0	0	0	0	0	0	0	0	0	0	0	0	0	0	0	0	0	0	0	0	0	0	98	0	0	0	0	0	0	0	0	0	0	0	0	0	0	0	0	0	0	0	0	0	39	0	0	0	95	0	0	0	0	0	0	0	80	0	0	0	0	0	59	0	0	0	42	0	0	0	0	0	0	0	0	0	0	0	0	0	0	0	0	0	1
9	0	0	0	0	0	0	43	0	0	0	0	0	0	0	88	0	0	85	0	0	0	0	0	0	0	21	0	0	0	0	0	0	0	0	0	0	0	0	0	0	0	0	0	0	64	98	0	0	0	59	0	0	0	0	0	0	0	0	0	0	0	0	0	0	0	0	0	0	0	0	0	0	0	0	0	0	0	0	0	0	0	69	0	0	0	100	0	0	0	0	99	0	89	0	0	0	90	0	16
11	0	0	26	10	0	4	0	91	0	0	0	55	0	0	0	0	0	0	15	0	100	0	0	0	0	0	0	0	0	0	0	0	0	65	0	0	66	0	31	0	0	0	0	14	0	0	73	0	38	0	0	0	0	24	0	0	0	0	0	0	0	0	0	0	0	0	0	11	0	0	0	0	0	0	0	94	0	0	3	0	0	0	0	86	0	0	0	0	36	0	0	0	0	0	0	0	0	0	39
14	59	0	0	0	0	0	0	0	0	0	3	0	0	0	0	0	0	0	0	0	54	0	0	0	96	66	0	0	0	0	0	0	0	0	0	0	0	0	0	0	0	0	0	0	0	0	0	36	10	0	7	0	93	0	0	0	0	0	0	0	0	0	0	77	0	0	14	0	0	0	0	0	0	0	0	0	0	0	0	0	0	0	0	0	0	0	0	0	0	0	0	0	24	0	0	0	0	0	77
33	0	38	0	0	0	0	0	0	61	44	0	0	0	0	94	0	46	0	0	0	0	0	57	0	0	0	0	55	99	0	0	0	0	0	0	0	0	0	0	17	0	0	95	20	87	70	0	23	65	0	0	0	0	0	0	0	0	0	0	0	0	0	0	0	0	47	0	0	0	0	0	0	0	7	0	0	0	0	0	0	74	0	0	75	0	0	83	0	0	0	0	0	0	0	0	37	91	0	31
45	0	0	0	0	0	0	0	0	0	0	0	0	85	0	0	87	99	0	0	0	98	81	30	0	0	0	0	0	0	0	0	0	0	0	0	0	0	0	0	0	0	0	0	36	91	0	0	0	0	0	0	0	0	0	0	0	0	46	0	0	0	0	0	0	0	0	0	0	0	0	0	0	5	0	0	0	0	0	0	0	57	0	0	0	0	0	0	0	19	0	0	0	0	0	0	0	0	0	57
94	0	0	0	0	0	0	0	0	0	0	0	0	0	0	0	0	0	0	0	0	0	0	0	0	0	79	0	0	0	0	0	0	0	0	0	0	51	0	0	0	0	0	46	0	0	12	0	0	0	0	0	0	20	64	0	0	0	0	75	0	0	0	0	0	0	0	0	0	0	0	0	0	20	0	0	0	0	0	0	0	0	38	0	0	0	0	0	0	0	0	0	0	0	0	0	0	0	0	86
85	51	0	6	0	0	0	0	0	0	0	94	0	0	0	0	0	0	0	0	0	0	0	0	0	25	0	0	0	0	0	0	0	0	0	0	0	0	0	0	0	2	0	63	0	0	0	0	0	0	0	0	0	0	0	0	0	0	0	0	0	0	36	0	0	63	0	64	0	0	0	0	0	0	0	97	0	0	0	0	0	0	0	0	60	0	0	0	0	0	0	85	0	0	0	50	0	0	0	35
14	0	0	0	0	0	0	0	0	0	0	28	0	0	0	0	0	0	0	0	0	0	0	0	37	0	0	0	0	0	79	0	9	0	0	0	0	2	0	0	0	0	0	0	0	0	0	0	0	0	0	0	0	0	0	0	0	0	0	0	0	0	0	0	0	0	12	0	0	0	0	0	0	0	0	35	0	0	0	0	0	0	0	0	0	0	0	0	0	0	0	0	0	24	20	0	0	0	0	73
30	0	0	0	24	0	5	0	0	0	0	0	38	0	47	0	0	0	7	0	0	0	0	0	0	0	0	0	0	90	0	0	0	0	0	1	0	0	0	0	0	0	54	0	0	0	0	43	0	17	0	0	0	0	74	0	0	0	0	0	53	0	0	0	0	0	0	0	0	0	0	0	0	0	0	0	0	27	0	0	0	0	0	0	0	0	78	0	0	0	0	0	0	92	0	0	0	0	63	40
52	0	48	0	0	0	0	0	0	0	0	0	0	0	0	0	0	0	0	0	0	0	0	0	0	0	0	0	0	0	0	32	0	66	0	0	0	0	0	0	0	0	0	0	0	0	0	0	0	0	17	0	0	0	0	0	0	0	0	55	0	0	0	0	0	0	0	45	0	0	0	0	21	0	0	68	0	100	0	0	0	0	0	0	0	0	0	0	0	0	0	5	0	0	0	0	0	0	0	22
76	55	0	0	2	0	0	0	0	0	0	0	0	0	0	0	0	0	0	0	0	0	0	84	0	0	0	0	0	0	0	0	0	0	0	0	0	80	0	0	0	0	0	0	0	0	77	0	0	0	0	0	0	0	0	0	0	0	0	0	61	0	67	0	0	0	0	0	0	0	0	0	0	82	0	0	0	72	23	7	0	0	0	0	0	0	0	0	0	0	0	0	0	0	0	0	0	0	0	13
40	0	0	0	87	0	0	58	0	0	0	0	0	0	0	0	0	0	0	0	0	0	0	0	0	0	0	0	64	0	1	0	0	0	94	0	0	0	0	0	0	84	0	0	0	0	0	57	0	0	85	0	0	0	0	0	0	0	0	0	0	0	27	20	0	0	84	13	0	0	0	0	0	0	0	42	0	0	0	0	0	0	0	0	0	0	0	0	0	0	0	0	0	0	0	68	30	0	0	70
59	0	0	3	0	0	63	0	0	0	95	0	0	25	0	0	0	99	0	0	0	0	50	0	0	0	92	63	0	0	2	9	0	0	0	0	65	0	35	0	0	0	0	0	0	0	0	0	0	0	0	0	0	0	0	38	0	0	100	0	0	0	0	0	0	0	0	0	0	0	11	0	0	63	0	0	0	0	0	0	0	0	0	0	0	0	0	0	0	0	0	0	0	0	0	24	28	0	0	94
60	0	0	0	0	0	0	0	0	0	0	92	0	0	0	0	0	0	0	0	0	0	0	0	0	0	0	0	0	61	0	0	0	0	0	0	0	45	0	0	0	0	0	0	0	0	0	0	0	0	0	0	0	0	0	0	0	0	37	0	0	0	80	0	0	0	0	0	0	0	0	0	0	1	0	0	0	0	0	0	0	0	0	23	0	0	0	0	0	50	0	0	0	0	0	0	0	0	0	54
83	0	0	0	0	0	0	0	0	18	0	0	0	0	0	0	0	0	0	0	0	0	65	0	0	0	0	0	0	0	0	56	0	0	0	37	0	0	0	0	0	0	0	0	0	0	0	0	0	2	0	57	0	0	0	96	90	0	0	9	0	65	62	0	0	0	0	0	0	0	41	0	69	0	0	0	0	0	0	0	0	0	0	0	0	0	0	65	0	0	0	0	0	0	0	31	0	0	0	18
10	0	0	34	84	0	0	42	92	0	0	63	0	0	0	54	0	0	0	0	0	0	0	63	0	0	0	0	0	0	0	29	0	0	0	0	0	0	0	0	66	98	0	0	0	0	17	0	0	3	0	0	66	0	0	79	0	0	0	0	0	65	31	0	0	0	0	0	0	0	88	0	0	0	0	0	2	0	0	0	0	61	0	0	0	0	0	0	0	0	0	0	0	7	0	0	0	0	38	23
38	0	0	0	0	0	0	0	0	0	0	0	1	66	0	0	0	0	0	0	0	0	0	0	0	0	0	0	0	0	74	0	0	0	0	0	0	0	80	0	12	0	0	0	0	0	7	0	0	0	0	0	0	0	0	0	0	0	0	0	0	0	62	0	0	0	0	0	0	0	85	97	0	0	19	0	0	50	0	0	0	0	0	0	0	0	0	0	58	0	61	37	0	0	0	82	0	0	0	49
44	0	0	64	0	0	0	7	51	0	0	0	1	0	0	92	0	0	94	97	0	0	0	0	0	35	0	0	0	0	0	0	0	0	0	0	0	0	0	0	0	0	0	27	0	47	0	0	0	0	0	0	0	49	0	0	0	0	0	0	51	0	0	0	0	0	10	0	0	0	0	67	0	5	0	0	0	0	0	0	0	47	0	0	0	0	0	0	0	97	0	0	0	0	23	0	0	0	48	90
95	0	45	0	0	0	0	0	41	0	0	0	0	0	15	0	0	0	0	0	0	0	0	47	0	0	0	14	0	0	0	0	0	0	0	0	0	0	0	0	0	0	0	0	0	78	0	0	0	0	0	0	0	49	0	0	0	0	0	0	0	74	0	0	0	0	6	54	0	0	0	0	0	0	0	98	0	0	0	0	0	0	42	0	0	0	16	0	0	0	0	0	0	0	0	0	88	0	0	58
99	0	0	0	0	0	0	0	0	0	79	0	0	51	0	0	61	0	0	0	0	0	0	0	0	0	0	0	0	0	0	0	0	95	0	0	0	0	0	0	0	0	0	0	0	61	0	0	28	0	0	0	4	0	0	0	0	0	0	0	0	0	69	13	91	0	0	0	0	0	40	93	0	0	0	0	0	0	98	0	0	0	0	0	0	0	0	24	0	0	0	0	0	0	0	0	0	0	0	52
37	0	0	90	0	0	7	0	0	0	0	0	0	0	0	0	0	0	0	0	0	0	0	0	0	0	0	17	0	0	0	0	0	0	0	0	0	0	0	0	0	0	0	43	0	0	0	0	0	0	0	0	0	0	0	0	0	0	0	0	0	0	0	0	0	0	0	0	0	0	0	0	0	0	0	0	0	75	0	0	0	0	0	0	56	0	0	0	0	0	0	0	0	0	0	85	0	0	0	73
50	0	0	0	0	0	0	0	0	0	0	0	0	0	0	23	0	0	0	0	0	0	0	0	0	81	0	0	27	0	0	0	0	0	0	0	41	0	9	0	0	0	0	0	0	0	42	0	0	0	0	0	68	0	0	0	0	0	57	0	0	0	0	0	0	0	0	0	0	0	0	89	0	0	0	0	0	0	0	0	0	0	0	0	0	0	0	0	0	0	97	100	0	0	0	0	0	39	0	98
15	0	0	0	0	0	0	0	0	0	0	0	0	0	0	0	0	0	6	0	0	0	0	0	0	0	0	0	81	0	0	0	0	0	0	0	0	0	0	12	0	0	0	0	9	0	0	0	0	0	0	0	86	0	0	68	0	79	0	31	0	0	0	0	0	0	0	0	0	71	0	0	0	0	0	0	0	0	0	0	0	72	0	0	0	0	0	0	0	0	0	0	0	0	0	0	0	0	0	95
30	0	0	0	0	0	0	0	0	90	0	0	0	0	0	0	72	30	0	0	0	0	0	0	0	0	23	0	41	0	0	0	0	0	0	12	0	0	0	0	0	0	80	0	0	0	0	0	0	0	0	0	0	0	0	28	0	0	0	0	0	0	0	0	0	0	0	29	31	0	0	0	0	0	0	0	0	0	0	0	0	92	0	0	0	41	0	0	0	0	44	0	0	0	0	15	0	0	0	98
2	0	0	0	0	0	0	0	0	0	0	0	66	0	0	0	0	0	0	97	0	0	0	0	0	0	0	0	0	0	0	0	0	0	0	15	11	0	0	0	0	0	0	0	0	0	0	0	0	0	0	0	0	0	0	0	0	0	0	22	0	0	0	0	71	33	0	0	0	0	0	0	0	0	0	0	0	0	0	74	0	0	0	0	0	0	0	0	0	0	0	0	0	0	0	0	0	7	0	40
83	0	0	0	0	0	0	25	0	0	0	31	0	0	0	0	0	0	0	0	0	0	0	0	0	0	0	0	0	74	0	0	0	0	0	0	0	0	0	0	0	0	0	0	0	0	45	0	39	0	11	0	0	49	0	0	0	0	0	0	0	0	0	0	0	0	0	0	0	96	57	0	0	0	0	0	0	21	0	0	0	39	0	10	1	0	0	0	0	0	0	0	18	85	0	0	0	91	0	46
97	0	0	0	0	0	0	0	0	0	0	0	0	0	31	4	0	0	0	0	0	0	0	0	0	0	0	100	0	0	0	0	0	27	0	0	32	0	0	0	0	0	0	0	0	0	0	0	0	0	0	0	0	0	0	0	0	0	49	0	3	0	0	0	0	0	0	0	0	0	0	0	64	97	0	56	6	0	0	0	66	0	0	0	0	41	0	0	0	0	0	0	0	0	100	0	16	0	0	26
42	75	0	0	0	0	0	0	0	0	0	0	0	0	0	0	0	0	0	55	0	36	0	0	0	0	0	0	0	0	75	0	0	0	0	8	62	0	0	0	80	0	0	0	0	10	0	24	0	0	0	69	0	0	0	0	0	0	34	0	0	0	35	0	0	0	0	0	0	0	0	56	47	94	0	0	0	0	0	96	0	85	0	0	0	0	0	0	0	41	0	0	0	0	0	0	0	66	0	62
55	0	0	0	0	0	0	0	0	0	0	0	0	0	0	0	0	0	0	0	0	79	0	0	0	62	0	0	39	0	0	0	0	95	0	72	0	0	0	85	90	67	0	0	0	0	0	0	0	0	0	0	0	0	0	0	0	0	0	0	0	0	0	0	0	64	0	53	0	0	0	0	0	0	0	7	0	14	0	0	0	0	79	34	0	0	87	0	0	0	0	0	25	0	0	0	0	0	0	60
71	0	0	0	0	0	0	0	0	0	0	52	0	63	0	0	0	0	0	0	0	0	0	0	0	0	0	4	0	0	7	0	0	0	0	0	0	0	0	0	0	0	0	0	0	0	0	0	0	0	0	0	0	13	51	15	0	0	0	6	0	7	0	0	0	0	0	87	0	0	3	0	0	0	0	0	0	0	0	0	0	0	0	13	0	0	0	0	0	71	0	0	0	0	0	0	21	57	0	1
99	0	0	0	39	0	0	0	0	0	0	0	0	0	0	0	85	0	0	0	0	0	0	0	0	0	0	75	0	0	0	0	0	0	0	67	0	-1	0	0	0	1	0	0	0	0	0	0	69	37	6	0	0	0	0	0	0	0	0	0	0	52	0	0	0	0	0	0	0	0	0	0	0	0	0	0	0	0	0	0	15	0	0	0	0	3	0	0	0	0	0	0	0	0	0	100	0	0	87	85
67	0	59	0	0	0	0	84	0	63	0	0	0	28	59	0	0	0	0	0	0	0	0	0	0	0	0	0	0	0	0	34	0	81	0	0	0	0	0	0	0	0	0	0	0	0	0	0	0	0	0	0	0	0	0	0	0	0	0	0	0	0	0	0	55	0	0	0	0	0	0	0	0	0	0	0	0	0	0	0	0	36	26	0	0	0	0	0	6	0	0	0	0	0	0	90	0	0	0	62
25	69	46	10	34	67	10	35	11	98	30	49	90	63	65	33	46	48	84	49	93	69	83	92	18	11	8	26	34	3	76	79	67	75	43	82	93	45	44	8	85	30	27	69	31	70	48	35	84	85	71	97	31	3	56	84	51	94	93	24	18	31	86	1	50	93	71	46	63	76	9	20	55	72	48	63	21	86	19	9	55	41	86	78	31	57	49	16	62	98	40	23	12	7	49	12	31	65	15	2
