12	4	8	9	4	19	3	10	16	3	15	14	18	3	7	18	18	10	14	17	13	7	11	19	17	4	2	12	3	6	10	4	1	4	2	20	19	2	13	16
20	10	9	8	19	8	12	6	10	13	2	5	12	17	3	20	13	4	19	20	7	7	15	18	1	1	17	3	4	1	0	3	0	14	6	6	17	16	2	13
19	6	7	4	3	0	6	1	8	17	18	10	5	20	16	18	12	11	9	10	12	16	11	4	3	16	19	3	18	7	10	18	3	11	11	17	12	9	6	18
1	18	14	2	20	7	7	8	9	2	3	16	5	3	4	16	2	13	1	17	0	2	11	12	12	6	12	14	10	4	18	18	14	14	3	14	7	5	9	20
3	17	3	2	1	9	15	8	17	8	9	15	16	3	5	3	6	10	0	12	16	5	1	1	5	19	15	18	3	15	20	18	5	1	18	4	16	16	6	18
1	6	1	7	2	2	0	19	19	9	8	17	20	1	4	3	0	7	7	4	4	19	15	10	20	5	13	7	14	7	19	14	20	6	1	3	7	7	7	6
20	0	16	1	13	9	4	13	12	17	17	18	16	12	11	2	9	4	11	11	10	5	7	7	12	2	19	15	3	9	19	20	14	2	11	2	14	1	7	10
7	0	0	8	20	1	9	12	2	1	1	4	18	20	16	1	8	19	15	9	8	9	7	17	9	2	12	10	6	0	5	7	10	10	13	15	5	10	14	11
17	17	3	8	17	6	13	17	1	8	15	13	4	13	0	8	14	4	7	18	6	13	16	8	12	11	11	10	9	17	8	4	1	20	4	14	16	5	19	19
9	8	16	6	6	1	15	14	8	10	6	20	18	10	13	4	9	13	20	10	8	17	8	9	13	5	14	13	7	13	19	15	6	13	15	2	4	1	9	19
5	5	5	16	8	2	11	7	9	5	12	13	12	15	19	5	19	18	0	5	6	10	11	11	10	17	11	1	2	6	16	20	8	1	15	15	19	2	3	16
20	19	20	3	17	10	12	6	8	16	4	17	10	11	12	18	13	17	15	18	2	0	14	9	18	19	2	2	19	5	12	8	6	20	16	5	6	5	7	11
10	19	7	6	15	2	4	1	13	9	0	12	13	0	15	3	13	19	16	4	1	19	14	20	3	2	12	3	18	12	17	9	18	14	16	11	5	4	17	2
16	0	14	6	14	3	4	3	8	12	3	1	8	11	5	8	5	1	11	7	0	5	3	3	19	19	19	19	5	3	6	17	10	6	18	14	16	0	14	19
15	7	4	17	14	0	11	1	12	7	16	14	6	19	14	20	14	17	13	3	10	13	11	13	2	2	8	13	0	5	19	20	16	12	11	15	0	14	13	1
16	9	9	20	9	18	10	5	19	12	20	20	12	17	6	15	7	13	16	0	9	15	10	6	2	19	4	18	10	11	11	6	3	2	19	3	10	20	9	17
16	12	18	15	0	19	16	1	20	6	16	19	7	7	5	6	18	20	3	7	9	1	11	9	18	19	0	8	9	7	6	8	13	3	10	14	1	1	2	5
7	1	8	15	1	2	10	7	12	7	0	20	12	4	0	9	3	9	16	6	20	11	12	18	3	4	10	14	17	1	20	15	14	2	0	3	11	9	10	10
5	1	2	5	14	9	10	20	11	5	17	16	19	20	7	9	16	13	9	2	10	6	7	19	6	0	13	15	12	19	7	14	2	12	15	4	20	8	1	7
18	2	11	5	18	8	5	16	13	14	17	8	15	13	16	4	16	9	9	3	3	4	11	17	0	12	14	5	0	14	5	16	16	3	11	18	16	11	18	9
19	17	7	12	4	20	6	10	7	10	15	11	2	17	19	1	4	12	20	5	20	3	7	17	7	8	14	14	13	17	10	10	11	8	7	15	12	12	3	9
6	5	14	6	8	11	18	13	20	7	4	1	2	18	18	8	20	8	19	16	14	3	6	1	10	19	3	19	2	3	11	9	3	12	16	7	18	18	15	16
13	13	20	15	6	15	3	5	18	1	3	11	12	19	14	16	14	7	13	5	13	12	6	19	18	10	15	13	12	1	2	3	18	12	16	0	12	20	18	9
5	20	7	7	11	19	20	2	2	4	14	20	11	11	20	15	4	20	15	19	13	17	9	6	1	9	16	20	9	18	11	19	2	15	18	1	17	18	0	3
16	5	5	4	7	6	15	5	12	14	14	4	17	7	16	9	16	17	4	16	3	2	8	8	11	12	2	10	0	13	20	4	5	17	13	9	0	7	9	16
11	19	16	1	17	20	1	8	16	19	17	6	14	0	10	8	6	6	8	0	2	3	9	6	11	14	19	12	8	3	20	2	20	5	17	1	3	1	2	18
20	4	3	2	0	4	4	14	17	11	1	12	9	1	1	13	7	15	9	6	4	2	3	9	1	0	17	16	2	1	16	6	20	3	4	9	16	12	19	9
12	7	2	12	14	5	8	6	5	16	0	18	14	13	11	4	11	6	9	19	14	10	4	13	7	17	7	2	1	6	12	6	6	13	8	17	16	12	7	1
12	19	5	2	15	8	16	15	16	9	12	5	19	2	8	3	14	5	3	3	15	19	8	4	2	5	4	17	20	16	3	12	7	10	7	19	2	3	20	14
11	2	4	4	5	3	13	5	1	7	6	14	16	20	9	8	18	0	0	0	11	16	0	17	6	20	9	10	11	18	2	8	1	13	0	17	13	11	3	3
4	19	0	12	9	0	14	10	2	4	1	8	11	15	5	17	7	0	-1	0	15	12	6	11	9	10	12	6	12	12	5	19	20	6	9	2	13	12	0	18
9	20	9	0	18	19	14	18	16	15	18	1	17	8	0	18	18	0	0	0	6	11	0	19	19	7	20	7	19	9	1	4	2	15	0	18	3	20	13	11
14	10	15	13	19	4	8	15	3	19	2	3	14	7	4	10	5	10	13	0	20	15	6	2	18	5	1	1	20	11	9	11	14	2	15	15	9	13	12	13
8	20	17	20	5	12	10	20	19	20	9	14	8	1	3	16	16	8	2	18	10	20	6	19	14	11	7	12	13	13	5	11	8	3	6	0	13	20	5	10
8	5	20	19	1	13	18	11	19	2	3	10	1	13	2	16	20	15	3	14	10	17	11	15	1	3	2	19	10	10	10	16	18	7	8	4	10	11	4	4
20	1	2	3	15	2	5	13	12	11	7	1	16	16	2	0	15	3	13	19	12	6	10	4	12	9	17	18	6	3	14	14	2	18	15	9	8	0	19	17
4	3	7	9	9	11	17	8	4	17	14	18	14	0	4	0	4	6	11	3	16	5	8	15	7	8	5	3	18	8	18	19	15	18	20	8	3	12	10	15
4	7	15	0	18	18	11	1	20	5	8	11	12	5	17	0	19	5	5	4	18	18	3	7	14	1	9	1	5	7	16	9	2	8	2	17	10	1	15	9
14	7	17	12	19	9	0	14	5	14	7	7	19	10	14	20	4	10	12	8	0	19	1	10	1	12	15	1	10	18	18	4	1	8	10	0	8	10	12	1
2	14	17	2	13	10	8	3	6	17	14	11	12	1	12	1	4	18	5	1	19	5	15	7	7	11	2	3	3	2	12	1	2	3	20	8	7	17	19	13
